5 5
1 1
WWWWW
W   W
WW  W
W  WW
WWWWW